Glycine	Gly	G	
Proline	Pro	P	
Alanine	Ala	A	
Valine	Val	V	
Leucine	Leu	L	
Isoleucine	Ile	I	
Methionine	Met	M	
Cysteine	Cys	C	
Phenylalanine	Phe	F	
Tyrosine	Tyr	Y	
Tryptophan	Trp	W	
Histidine	His	H	
Lysine	Lys	K	
Arginine	Arg	R	
Glutamine	Gln	Q	
Asparagine	Asn	N	
Glutamic_Acid	Glu	E	
Aspartic_Acid	Asp	D	
Serine	Ser	S	
Threonine	Thr	T
iMethionine	iMet	M