STOP 	TAA, TGA, TAG 
Ala 	GCT, GCC, GCA, GCG 	 	
Arg 	CGT, CGC, CGA, CGG, AGA, AGG 
Asn 	AAT, AAC 
Asp 	GAT, GAC 
Cys 	TGT, TGC 
Gln 	CAA, CAG 
Glu 	GAA, GAG 
Gly 	GGT, GGC, GGA, GGG 	 	
His 	CAT, CAC  	
Ile 	ATT, ATC, ATA
Leu 	TTA, TTG, CTT, CTC, CTA, CTG 
Tyr 	TAT, TAC 
Val 	GTT, GTC, GTA, GTG 
Trp 	TGG
Met 	ATG
Phe 	TTT, TTC 	
Pro 	CCT, CCC, CCA, CCG
Ser 	TCT, TCC, TCA, TCG, AGT, AGC 	
Thr 	ACT, ACC, ACA, ACG 	
Lys 	AAA, AAG 